010000000001000001000000010100010000000000010001010001000001
011101111101111101011111010101010111111111010101010101011101
000101000100010001010100010001000100000001010100000100010001
110101110111010101010101111101111111111101010111111111110111
000100010001010100010100000101000000010001000000000000010001
011111011101010111010111110101011111010111111111111111011101
010000010001000100010100000101010000010000000000000001010001
011101110101111111110101111101010111111111011111111101011111
000101000100000001000101000001010000010001010100000101000001
110101010101111101011101011111011111010101010101110101111101
010101010101000100010001010000010001000100010000010100010001
010101010101010111110111010111110101111111111111010111010101
010001010101010001000100010100010100000001000100010000010101
011111010111011101011101110101010111111101010101111111110111
00000001000001000100010001S001010000000100010000000100010001
111111111101110101110111011111010111111111111111111101011101
000000000100010101010101000100010100010000000000010001000101
011111110111110101010101110101111101010111111101010111011101
000100010000000100010101010100000001000100000101000100010001
010101011111110111110101010101111111111101110111111101110101
010101000000000100010100010100000001000100010100000001000101
110111111111111101010101010111111101010111010101111111011101
000100000000000101000101010001000001010001010000000101000101
011101111111011101111101011101011111010111011111110101110111
010001000001000001000001010001000100010100010000010001010001
010111011111111111011111010111110101111101111111011101011101
010100010000000000010001010101000100000100000101000001010001
010101010101111111110101110101011111110111110101011111010111
010101000100000100010100000100000000000001000101000100010001
010101111101010101010111111101111111111101011101110101111101
010101000101010001010100000001000100010101000101010000010001
010101010101111111010111111111010111010101110101011111010111
010100010100000001010000000100010100010000010101000100010001
010111110111111101110111110101110101110111110101010101111101
000001000100000100000100010001000100010101000100010100010001
111101110101110111111101011111011111010101011101110111010101
000101000101000100000101000001000001000101010100010000010101
010101011111011101110101111101111101110101010111011111110101
010101010000010001000001000100000100010001010001010001000101
011101011101010111111111011111110111011111011101010101011111
000001010001010000010000000001000100000001000101000101010001
011111010111011111011111011101011111111101110101111101010101
010001000100010001010000010001000000010000000100000101000101
010101111101110111010111110111111111011111111101111101111101
000101010001000100010100010000000001000000010001000001000101
111101010111011101110101111111111101111111010101011111010101
000101010101010001010100000100010001000101010100000100010101
011101010101010111010111010101010101110101011111110111011101
0000010000000100010000010101010G0101000101000100010100010001
011111111111111101111101010111111101010101110101010101010111
000100000000010000010100010000010001010000010001010001010001
110111010111011101010111110111010111011111111111011111110101
010001010100000101010100000100010100010000010001010001000101
011101010111110111010101111101110101010111010101010101011101
010001010000010000010000000101010001010101000101010100010001
010111111111011111111111111101011111010101111101010111110111
010000010001000101000100000001000101010001000100010101000101
011111010101110101010101111111010101011101110111110101010101
000000000100000100010000000000010001000000000000000100010001
111111111111111111111111111111111111111111111111111111111111