000000010100000000010000010001000000000101000000000000010001
111111010101111111011111010101011101110101011111111111011101
000001000001000001000001000100010001010001010000000100000101
011101111111110101111101111111010111011101011111011101110101
000100000100000100000100000100010100010101010001000101010001
111101011101011111111111110101110111010101010101110101G10111
000001010001010000000000010100010100010001000100010000010001
011111010111010111111101110111110101110111111101011111111101
010100010001010001000100010000010100010100000101010000010001
010101111101011101110111011111010101010101110101010111010111
010001000001000100010001010001000101000101000101000100010001
011111011111011111011101010101111101111101011101111101111111
010000010001010001000001000100000101000001000101000100010001
010111110111010101110111010111110101011101110101010111010101
000100000100010100000100010100010101000100010100010101000101
110101111101110111111101111101011101110111010111110101111101
000001000001010001000100000001000100010100010100000101000001
011111011101011101011111111111110111011101110111110101011111
010000010000000101000000010000010101000001000100010101000001
010111110111110101111111010111010101111111011101010101111101
010001000100000100000000010100010000010001000001010001000001
011101111101111111111111011101111111010101111111011111011111
000101000101010000000001000100000001000101000100010000000001
110101010101010111111101110111011101011101010101110111111111
000101010100010100000001010000010001000100010100010000010001
011101010111010101111111011111110111110111110111010111010101
010100010001010100000100000100010100010001000100010001000101
010111111101011111110101010101110111011101111101111111011101
000000010001000000000101010001000000000100010001010001000101
111111110111111111011101011111011111111111010111010101110101
000000000101000000010001000000010100000000010000000100010101
011111111101011111110111111111110101111111011111111111011101
010000010000010001000101000000000101000100010001000101000101
011111010111111101011101010111110101010111110101010101110101
010001000001000001010000010100010100010100010101010000010001
010101111101110111010111110101010111110101011101011101111101
010100010000000100010100010101010000010001010000010000010101
010111011111111101110101011101011111011111010111111111010101
000001010000000100010001010001000000000001000000000100010001
111111010111110111011111010111011111110111111111010111010111
000000010000010001000001010001010001000000010001010001010001
011111111111010111111101111101110101011111110101111101111101
000000010100010001000100000101000101010000000100000100010001
011111010101111101011111110101011101010111111101011111010111
000001010101000100000100000100010001010100010101010000010101
011101010101010111110101111101110111110111010101010111110101
010101000101010100000100000101010000010001000101010000000101
010101111101110101111111110101011111011101110101011111111101
000100000001000100000000000100010000000100000101010001000001
111101011111011111111111111111110111111101111101010101110111
000101000001000000000000010000010001000001000001000100010001
011101111101111111111101010101011101011111011111111111011101
00010100010000000000010101S101010000000001000100010001000101
110101011111111111110101011101011111111111110101011101110101
000101000000000000010001000101000000000000010101000100010101
011101111101111101111111110101111111111111010101110101010101
000101010001000001000000000101000100000100010001000101010101
110101010101111111011111111101011101011101111111011101010101
000001000100000000000000000001000001000000000000010001000001
111111111111111111111111111111111111111111111111111111111111