11111111111111111110
11111111111111111110
11111111111111111110
11111000011111100000
11111011011111101110
111110110G0001100110
11111011111101110110
11111011111100000110
11100011111111111110
11101110001111111110
11100000100111111110
11111111110111111110
11111111110000001110
11111000011111101110
11111011011111101110
11111011000001100110
11111011111101110110
11111011111100000000
11100011111111111111
S0001111111111111111
