01000000000001000001000001000100010001000000010000000000000S
011111110111011111010101011101010101010101110101011111110101
000001000100000000010101010001010001010100010101010000010101
111101111101111111011101010101010111110111010101110111010101
000100010001000000010001010101010000000100010100010001000101
010111010111011111110111010111011111111101011111010101110101
010100010101010100000001010001000100000001010001010100010101
011101110101010101111101010101011101111111010101011111010101
000100010100010001000101010100010001000000010101010001010101
110111010101111101110101011111110111111111110101010101010101
000001000100000100000101000001000000010000000100000101010101
011101111111110111111101111101011111010111111111111111010101
000101000000010100010001000001010001000100000100000000010101
010101010111110101010111011111011101011101110101111111110101
010101010100000101000100010000000001000101010001000000010001
110101110101111101111111011111111111111101011111010101111101
000100010101000001010000010000000000000101000001010101000101
011111010101011111010111110111011111110101111101010111010101
000100010101010100000100000100010001000100000100010001010101
110101110101010101111101111101111101011101010111111101010101
000100010100010001000100010001000001010001010100000001010001
011111010111110111010111110111011111010111110101111101011111
010001010000010001010001000100000001010100010101000001000001
011101010111111101011101011101111101011101010101111111111101
010001010000000101000101000100010001000001010100000000000001
010111010111110101111101110111110111111111010111111111111101
010001010000010100000001000100000100000000010100010001000101
011101011111110111111101011101111101111111110101010101010101
000100010001000100010101010100000100010001110001000101010001
010101110101010101010101010101110111011101110111111101110111
010100000100010001000100010100010001000100000100000100010001
010111111111111111110111110101110101110111011111110111011111
010000000000010001010000000100010100010001000001000001000001
110111110111110101011111110111010111111101110101011111111101
000100000100000100010001010001010000000100010100010001000001
011101111101111111010101011101011111011111010111110101011111
010001000101000001010101000001010001000101010100000100000001
010111010101011101010101111101010111110101011101111111111101
010001010001000100010100000101000100000101000100010000010001
010101011111110101110111110101110101110101110111010111011101
010101000100000101000100010101000101010101000100010001000101
010111110101111111011101110101111101010101011101111101110111
010001000100000000010001000100010001010101010100000000010001
011101011111111111110101011111010111010101010111111111111101
000101000001000001000101010001000100010001000000010000000101
011101111101011101111101010101111101111101111111010111110101
000100000001000100010101000101000000000000000001000100000101
110111111111011111010101111101111111110111011111111101111101
010001000000010001000100000100000100000100010000000101000001
011101111111010111110111110111110101111101110111110101010101
00010100000101G000010000010000010100000101000100010001010101
011101011101010111011111011101010111110111011101011111110101
000001000100010101000001000001010000010001010001010001000101
011111110111110101011101111111011111011101010111011101011111
000000000100010001000100000100010001000101010101010001000001
111111111101110111110111111101110101110101010101010111011101
000100000001000000010000000101000100010101010100010000000101
011101110111010111111111110101111101010111010101111111111101
000001000000010000000000010000000001010000000100000000000001
111111111111111111111111111111111111111111111111111111111111
