1111111111111111111G
11111111111111111110
11111111111111111100
11111000011111100001
11111011011111101111
11111011000001100111
11111011111101110111
11111011111100000111
11100011111111111111
11101110001111111111
11100000100111111111
11111111110111111111
11111111110000001111
11111000011111101111
11111011011111101111
11111011000001100111
11111011111101110111
11111011111100000111
11100011111111111111
S0001111111111111111
