010001000000000001000001010000010001000001000000010000000001
010101011101111101010101010111010101011101011111010111111101
010101000100010001010101000001000100010001000001010101000001
010111110111010111010101011111011111110111011101010101011111
010000000101010100010101010001010000010100000101010100010001
011111011101011101110101110101010101110111111101010101110101
010001000001010001010100000100010100010100000001000101000101
010101111101010111010111111111010111010101111111111101110111
010101010001010100010000000001010100010001010000000100010001
010101010111010101011111111101110111110111010111110111010101
000101010001010101000000000100010G00000100000000010000010101
111101010111010101111111111111011101111111111111011111111101
000001000001010001000001000001010001000001000001000000010001
111101111101010111011101011101010101110101110101111111010111
000100000101010000010101010101010101000100010100000001010001
010111110101011111110101010101010111011111011111111101011101
010000000101000100000101010101010100010001000100000001000101
011111111111010111010101010101011101111101110111011101110101
000100000001010001010100010001000100010001010100010101000001
110111011101011101010111110111110111010101010101110101011111
000100010001000100010100010100010001000100010100010001010001
011101110111110111111101010101011101110111110111011111011101
000101000100000101000001000101000101000100000001000001000101
110101011111010101011111110101110101010101111111011101110101
010101010001010100000100010100010100010101000100010101010101
010101010101110101111101010111110101111101010101110101010101
010001000100010001000001000000000101010001010001000100010001
011111111111011111011111111101110101010111011101010111011101
000000000101000001000100010001000100010100010001010001010001
111101110101111101011101010111111111110101111111110101010111
000001000001000101000101010100000001000100000000010100010001
011101111101010101110101010101111101011111011111011111111101
000100000100010101000101010100010001000001010001010000000001
011111110111111101111101011111011101010101011101010111111111
000100010001000101000001000001010001010101000001010100000001
110101111101010101011111111101010111011101111111010111110101
010101000001010001010000000100010001010001000000010000000101
010101011111011111010111110111111101110111110101111111111101
000101010000010000010001000100000001000100000101000100000001
011101010111110111111101111111011111011101110101010101111111
010001010100000000010000000001010001010001000101010001000001
010101010111111111010111111101010101010111010111011111110101
000101010000000001010000000101000100010100010100010000000101
111101011111111101011111110101111111110111010101110111011111
000101000000000101010001010100000100010100010101000100010001
010111111111010101010101010111110101110101111101010101010101
010000000001010100010101000100010100000100000001010101010101
011111111101110111110111011101010101111111111111110101010101
000001010S00000100000100010101010100000001000001000101010101
011101010111010111110101110101010111111101010111011101110101
010001000100010000000100000101000001010001010001000101000101
010111111101111111011111110101111101010111111101010101011101
010000000101000101010001000100000100010001000001010101000101
011111110111010101010101011101111111111101011101010111110101
010000000100010100010100010100000000000101000101010000000101
010111111101110111110111110111111111011101110101011111111101
010000000100010000010000010001000001000001000101000100000101
011111110101011111011111010101011101011111011101111101110101
000000010001000001000000000100010001000000000100000001000001
111111111111111111111111111111111111111111111111111111111111