0G0000010001000000000001000000000001000100010000000100010001
111111010111011111011101011111111111010101010111110101010111
000001010000010001010101000000000000010101000001000101010001
011101010111110111010101011111111111110101111111010111010101
010001010000010100010001000100000000010001000000010001010101
010111011111010101111101110111011111011111011111111101011101
010001010001000101000100010001010000010001000000010001000001
011101010101110101010111011101010111110101111111011111010111
000101000100010100010001010100010001000100010001000001010001
111101111111010111111101010111111101011111010101111101010101
000001000001010001000101010000000101010001000100000101010101
011101111101011111010101011101111101110101111111011101110101
010000000001000000010001000100000100010100000001010001000101
011101011111111111111111110111110111010111111101010111011101
000101010000000100000100010001000000010000010000010000010001
110101110111110101110101111101111111010111010111111111010111
000100000100000101010101000100010001010100010100000000010101
011111111101111101010101010111011101011101110101111111110101
000100010100000001000101010001000101000001010101010000000001
010101010111111111110101010101110101111111010101010111111111
010001010000000001000100010100010000010000010101000111111111
110111011111111101011111110111111111010111110101111111111111
000001000000000100010000000111000000010000000100000000000001
011111111111110101111101111111011111111111110111111101111101
000001000000010100000100000001010000000001000000000101000101
011101011111010111110111110101011111110101011111111101011101
010000010000010001010100010101000100000101000100000101000001
011111111111111101010101011101110101111101111101110101011111
010001000000000101010001000100010101000100000001000101010001
010101011111111101011111110101110101010111111111110101110101
000100010000000101010000010100010001010001010000000100000101
111101110111110101010111010111011111010101010111111111110101
000100010000010001010001010000000001010100010100000001000101
010111011111011111011101011111111101010111110101111101011101
010100010001000001010001000001000001010000010101000101000101
110101110101111101011101111101011111111111010111010101011101
000100010100010001000000010001010000000100010001010100010001
010111011101010111111101011111010111010101111101010111110101
010001000101010000000101000100010001010001000100010000000101
011111110101011101110111110101111101011111010111111111111101
010001000101000101000100000100000101010000010000000000010001
010101011101110111011101111111110101010111111111111111010111
010100010101000100010000000100010101010100000100000000010101
010111110101011101110111110101010111010101110101111111110101
000101000001000101000100010101010000010001010100000100010001
011101010111110101110101110101111111011111010111010101111101
010100010100010100010100010101000100010000000001010001000001
010101110111010111010111010101010101110111111111011111011111
010100010001000101010000010100010000010101000001010001010001
010111011101110101011111110101011111010101011101010101010111
010001000100010001010S00010001000100010101000100010100010001
011101011111011111010111011111110111110101110101110111111101
000100010001010000010001000001010100000100010100010000000101
110101110101010111011101111101010101111101010111011111110101
010101000101010001010001000101000101000001010100010000010001
010111010101011101010111010101111101011111010101110111011101
010000010101010001010100010101000001000100010100010001000101
011111110101010111110101110101011111110101110111110101111101
000000000100010000000001000100000000000100010000000100000001
111111111111111111111111111111111111111111111111111111111111