S00000010000010000000101000001000100010001010000000000000001
111111010111010111110101011101011101010101010111111111011101
010001000100010100010001010100000101000101000100000100010101
010101111101110101010101010111110101111101011101110111010101
000100000101000101010101000100010101010001010001000100010001
111111010101110101010111110101010101010101010111011101111111
000000010101000101010100010101010001000101010001000100000001
011111011101011101011101010101111111111101011101110101111101
000101000001000001010001000001000000000101010101010001010001
110101111111111111010111111111011111110101010101011111010111
010000010000000001010000010100010000010100000101000000000101
011111010111011101011111010101111101110111111101111111110101
000101010100010101000000010100000100000100000001000001010001
010101010101110101011111110111110101111101111101011101011101
010001010100010101000100000000010100000001000101000100000101
011111011111010101010111111111010111111101010111010111110101
010001000000010101010000000000010000000101010000010100010101
010101111111110101111111111111011111110101011111110101010101
010100010000000100000001000000000100010101000100010001010101
010111010101111111111101011111110111010111110101011111110101
000100010100010000010001010001010000010000000101010000000101
111101010111010101010111110101011111111101111101011101011111
000101010101000101010001000101000100000000000101000001010001
010101110101111101111101011101010101111111111101111111110101
010001000100000101000100010100010101000001000101000000000101
011101011111010101010111110111110101011111010101011111111101
010001010000010100010000010000000101000001010100010100000001
011101010111110111110111110111111101111101010111110101111111
000101000100000100010100010100000100000100010001000100000101
110111111101111101010101010101011111110111110101011111010101
000000000100010001010001000101000100010001000100010000010101
011111110101110111011111111111010101011101011101010111110101
010000000101000001000000010001010001000101010001010100010101
010111011101011101111111010101110111011101011111010111010101
010001010001000101010001000100010001000000010001010001010001
011111010111110101010111111111011101111111110101111101011101
010000010100000101010000000100010100000000010101000001000101
010111010111111101010101011101110111011111110101011111011101
010001010100000001000101000001000000000100000100010001000001
011101010101111111110111111111011111111101111111110101011111
000101010101000100000000000100000100000001000100010100010001
110101110101010111111111110101111101111111010101010111110101
010100000100010001010000000100010001000000010101010000000101
010111111111111101010111111111010111010111110101011111111101
000100000000000001010100010000010100010100000101000001000101
110101111111111101010111011111110101110111111101111101010101
000100000001000001000100010001000100010000000001000101010001
110101111101111111011101010101011111110111111111011101011111
000100010100000001000001000101000000010001000001000100010001
011111010111111101111111111101111111011101011101110111111101
000101010000000100000000010000000000010000010100010000000101
110101011111011111011111011111111111111111110111011111010101
000101010001010001000100010001000000000100000001010000010001
011101010101010101110101110101111111010101111101010111111111
010001000100010100010101000101000000010001000101010000000001
011101110111110101011101010101011101111111010111011111011101
000100000100000101010001010100010001000000010100010001000101
010111111101111101010111010111111111011111110101110101111101
010000000001000001000100010000000000000000010000G00100000001
111111111111111111111111111111111111111111111111111111111111